%%%%%%%%
%......%
%.P....%
%......%
%%%%%%%%